#
70 41
#
  ﹥﹥﹥﹥﹥            ﹥﹥﹥﹥﹥      ﹥﹥  ﹥﹥﹥          ﹥﹥    ﹥﹥﹥            ﹥            ﹥﹥﹥﹥        ﹥    ﹥﹥﹥          
﹥          ﹥      ﹥﹥          ﹥﹥﹥    ﹥      ﹥﹥    ﹥    ﹥﹥      ﹥﹥  ﹥﹥﹥  ﹥﹥    ﹥﹥        ﹥﹥﹥﹥  ﹥﹥      ﹥        
﹥            ﹥﹥﹥                                    ﹥﹥                    ﹥            ﹥﹥                                  ﹥﹥    
  ﹥                                                                                                                                    ﹥  
  ﹥                      ﹥﹥﹥﹥﹥﹥﹥﹥﹥﹥                                                                                          ﹥  
  ﹥                    ﹥﹥﹥﹥﹥﹥﹥﹥﹥﹥﹥﹥                                                                                      ﹥    
﹥                    ﹥﹥忙式式式式式式式式忖﹥﹥                                              ﹥﹥﹥﹥﹥﹥﹥﹥﹥﹥                  ﹥    
﹥                  ﹥﹥﹥弛 Weapon    Store弛﹥﹥﹥                                          ﹥﹥﹥﹥﹥﹥﹥﹥﹥﹥﹥﹥                  ﹥  
﹥                      ﹤戌式式式式式式式式戎﹤    忙><><忖                                ﹥﹥忙式式式式式式式式忖﹥﹥  忙式式式式忖  ﹥  
﹥                      ﹤﹤﹤﹤﹤﹤﹤﹤﹤﹤﹤﹤式式弛忙忖弛                              ﹥﹥﹥弛 General   Store弛﹥﹥﹥弛  vvvv  弛  ﹥  
  ﹥                    ﹤﹤﹤﹤﹤﹤﹤﹤﹤﹤﹤﹤    弛戌戎弛                                  ﹤戌式式式式式式式式戎﹤    弛 (≡≡) 弛    ﹥
    ﹥                  ﹤﹤﹤﹤﹤﹤﹤﹤﹤﹤﹤﹤     V____V                                   ﹤﹤﹤﹤﹤﹤﹤﹤﹤﹤﹤﹤式式弛 (≡≡) 弛    ﹥
    ﹥                  ﹤﹤﹤﹤﹤≒≒﹤﹤﹤﹤﹤                                              ﹤﹤﹤﹤﹤﹤﹤﹤﹤﹤﹤﹤    弛  式式  弛    ﹥
  ﹥                                                                                          ﹤﹤﹤﹤﹤﹤﹤﹤﹤﹤﹤﹤    戌式式式式戎    ﹥
  ﹥                                                                                          ﹤﹤﹤﹤﹤≒≒﹤﹤﹤﹤﹤                  ﹥  
﹥                                                                                                                                      ﹥  
﹥﹤﹤                                                                                                                                ﹤﹤﹥
﹥﹤﹤﹤﹤﹤﹤﹤﹤﹤﹤﹤                                                                                            ﹤﹤﹤﹤﹤﹤﹤﹤﹤﹤﹤﹥
﹥﹤﹤﹤﹤﹤﹤﹤﹤﹤﹤﹤﹤﹤﹤﹤﹤﹤﹤HHHH﹤﹤﹤﹤﹤﹤﹤﹤﹤﹤﹤﹤﹤﹤﹤﹤﹤﹤﹤﹤﹤﹤﹤﹤﹤﹤﹤﹤﹤﹤﹤﹤﹤﹤﹤﹤﹤﹤﹤﹤﹤﹤﹤﹤﹤﹤﹤﹤﹥
﹥﹤﹤﹤﹤﹤﹤﹤﹤﹤﹤﹤﹤﹤﹤﹤﹤﹤﹤HHHH﹤﹤﹤﹤﹤﹤﹤﹤﹤﹤﹤﹤﹤﹤﹤﹤﹤﹤﹤﹤﹤﹤﹤﹤﹤﹤﹤﹤﹤﹤﹤﹤﹤﹤﹤﹤﹤﹤﹤﹤﹤﹤﹤﹤﹤﹤﹤﹤﹥
﹥    ﹤﹤﹤﹤﹤﹤﹤﹤﹤﹤﹤﹤﹤﹤﹤﹤HHHH﹤﹤﹤﹤﹤﹤﹤﹤﹤﹤﹤﹤﹤﹤﹤﹤﹤﹤﹤﹤﹤﹤﹤﹤﹤﹤﹤﹤﹤﹤﹤﹤﹤﹤﹤﹤﹤﹤﹤﹤﹤﹤﹤﹤﹤﹤    ﹥
﹥              ﹤﹤﹤﹤﹤﹤﹤﹤﹤﹤﹤HHHH﹤﹤﹤﹤﹤﹤﹤﹤﹤﹤﹤﹤﹤﹤﹤﹤﹤﹤﹤﹤﹤﹤﹤﹤﹤﹤﹤﹤﹤﹤﹤﹤﹤﹤﹤﹤﹤﹤﹤﹤﹤              ﹥
  ﹥                                                                                                                                      ﹥
  ﹥                                                  ﹥﹥﹥﹥﹥﹥﹥﹥﹥﹥                                                                ﹥
  ﹥                                                ﹥﹥﹥﹥﹥﹥﹥﹥﹥﹥﹥﹥                                                              ﹥
    ﹥                                            ﹥﹥忙式式式式式式式式忖﹥﹥                                                            ﹥
    ﹥                                          ﹥﹥﹥弛     Hospital   弛﹥﹥﹥忙式式式忖                                                ﹥
  ﹥                                                ﹤戌式式式式式式式式戎﹤    弛  ﹥  弛                                                ﹥
  ﹥                                                ﹤﹤﹤﹤﹤﹤﹤﹤﹤﹤﹤﹤式式弛﹥﹥﹥弛                                                ﹥
﹥                                                  ﹤﹤﹤﹤﹤﹤﹤﹤﹤﹤﹤﹤    弛  ﹥  弛                                              ﹥  
≒                                                  ﹤﹤﹤﹤﹤﹤﹤﹤﹤﹤﹤﹤    戌式式式戎                                              ﹥  
﹥                                                  ﹤﹤﹤﹤﹤≒≒﹤﹤﹤﹤﹤                                                              ﹥
  ﹥                                                                                                                                      ﹥
  ﹥                                                                                                                                      ﹥
  ﹥                                                                                                                                    ﹥  
﹥                                                                                                                                    ﹥    
﹥                                                                                                                                ﹥﹥      
  ﹥                                                                                                                            ﹥          
    ﹥﹥﹥    ﹥﹥                    ﹥﹥                        ﹥﹥﹥﹥                      ﹥              ﹥  ﹥﹥        ﹥          
          ﹥﹥    ﹥      ﹥﹥﹥    ﹥    ﹥﹥﹥﹥﹥        ﹥﹥﹥        ﹥      ﹥﹥﹥﹥﹥  ﹥  ﹥﹥        ﹥  ﹥    ﹥﹥﹥﹥            
                    ﹥﹥﹥      ﹥﹥                ﹥﹥﹥﹥                ﹥﹥﹥          ﹥        ﹥﹥﹥﹥            ﹥﹥              
#
015015015015015015015015015015015015015015015015015015015015015015015015015015015015015015015015015015015015015015015015015015015015015015015015015015015015015015015015015015015015015015015015015015015015015015015015015015015015015015015015015015015015015015015015015015015015015015015015015015015015015015015015015015015015015015015015015015015015015015015015015015015015015015015015015015015015015015015015015015015015
015015015015015015015015015015015015015015015015015015015015015015015015015015015015015015015015015015015015015015015015015015015015015015015015015015015015015015015015015015015015015015015015015015015015015015015015015015015015015015015015015015015015015015015015015015015015015015015015015015015015015015015015015015015015015015015015015015015015015015015015015015015015015015015015015015015015015015015015015015015015
015015015015015015015015015015015015015015015015015015015015015015015015015015015015015015015015015015015015015015015015015015015015015015015015015015015015015015015015015015015015015015015015015015015015015015015015015015015015015015015015015015015015015015015015015015015015015015015015015015015015015015015015015015015015015015015015015015015015015015015015015015015015015015015015015015015015015015015015015015015015
015015015015015015015015015015015015015015015015015015015015015015015015015015015015015015015015015015015015015015015015015015015015015015015015015015015015015015015015015015015015015015015015015015015015015015015015015015015015015015015015015015015015015015015015015015015015015015015015015015015015015015015015015015015015015015015015015015015015015015015015015015015015015015015015015015015015015015015015015015015015
015015015015015015015015015015015015015015015015015015015015015015015015015015012012012012012012012012012012012012012012012012012012012012015015015015015015015015015015015015015015015015015015015015015015015015015015015015015015015015015015015015015015015015015015015015015015015015015015015015015015015015015015015015015015015015015015015015015015015015015015015015015015015015015015015015015015015015015015015015015015
015015015015015015015015015015015015015015015015015015015015015015015015012012012012012012012012012012012012012012012012012012012012012012012012015015015015015015015015015015015015015015015015015015015015015015015015015015015015015015015015015015015015015015015015015015015015015015015015015015015015015015015015015015015015015015015015015015015015015015015015015015015015015015015015015015015015015015015015015015015015
015015015015015015015015015015015015015015015015015015015015015015012012012012015015015015015015015015015015015015015015015015015015015015012012012012015015015015015015015015015015015015015015015015015015015015015015015015015015015015015015015015015015015015015015015015015015015015015015002002002002002002002002002002002002002002002002002002002002015015015015015015015015015015015015015015015015015015015015015015015015
015015015015015015015015015015015015015015015015015015015015012012012012012012015015015015015015015015015015015015015015015015015015015015012012012012012012015015015015015015015015015015015015015015015015015015015015015015015015015015015015015015015015015015015015015015015015015015002002002002002002002002002002002002002002002002002002002002002002002002015015015015015015015015015015015015015015015015015015015015015015
015015015015015015015015015015015015015015015015015015015015015015015015014014015015015015015015015015015015015015015015015015015015015015014014015015015015007007007007007007007007015015015015015015015015015015015015015015015015015015015015015015015015015015015015015015015015002002002002015015015015015015015015015015015015015015015015015015015015002002002002015015015015015015015015015015015015015015015015015015015015
015015015015015015015015015015015015015015015015015015015015015015015015014014014014014014014014014014014014014014014014014014014014014014014014015015015015007007004004004004007007015015015015015015015015015015015015015015015015015015015015015015015015015015015015015015002002002002002002015015015015015015015015015015015015015015015015015015015015002002002002002002015015015015006006006006015015015015015015015015015015
015015015015015015015015015015015015015015015015015015015015015015015015014014014014014014014014014014014014014014014014014014014014014014014014015015015015007007004004004004007007015015015015015015015015015015015015015015015015015015015015015015015015015015015015015015015015015015014014015015015015015015015015015015015015015015015015015015015015014014015015015015015015006006004004004004006006015015015015015015015015
015015015015015015015015015015015015015015015015015015015015015015015015014014014014014014014014014014014014014014014014014014014014014014014014015015015015007007007007007007007007015015015015015015015015015015015015015015015015015015015015015015015015015015015015015015015015015015014014014014014014014014014014014014014014014014014014014014014014014014015015015015015015006006001001001001006006015015015015015015015015
015015015015015015015015015015015015015015015015015015015015015015015015014014014014014014014014014014009009009009014014014014014014014014014014015015015015015015015015015015015015015015015015015015015015015015015015015015015015015015015015015015015015015015015015015015015015015015014014014014014014014014014014014014014014014014014014014014014014014014015015015015015015015015006006006006015015015015015015015015015015
015015015015015015015015015015015015015015015015015015015015015015015015015015015015015015015015015015015015015015015015015015015015015015015015015015015015015015015015015015015015015015015015015015015015015015015015015015015015015015015015015015015015015015015015015015015015015015014014014014014014014014014014014014014014014014014014014014014014014014015015015015015015015015015015015015015015015015015015015015015015
015015015015015015015015015015015015015015015015015015015015015015015015015015015015015015015015015015015015015015015015015015015015015015015015015015015015015015015015015015015015015015015015015015015015015015015015015015015015015015015015015015015015015015015015015015015015015015014014014014014014014014014014009009009009014014014014014014014014014014015015015015015015015015015015015015015015015015015015015015015015
015015015015015015015015015015015015015015015015015015015015015015015015015015015015015015015015015015015015015015015015015015015015015015015015015015015015015015015015015015015015015015015015015015015015015015015015015015015015015015015015015015015015015015015015015015015015015015015015015015015015015015015015015015015015015015015015015015015015015015015015015015015015015015015015015015015015015015015015015015015015
015015007007007007015015015015015015015015015015015015015015015015015015015015015015015015015015015015015015015015015015015015015015015015015015015015015015015015015015015015015015015015015015015015015015015015015015015015015015015015015015015015015015015015015015015015015015015015015015015015015015015015015015015015015015015015015015015015015015015015015015015015015015015015015015015015015015015015007007007007015015
015015007007007007007007007007007007007007007007007007007007007007007007015015015015015015015015015015015015015015015015015015015015015015015015015015015015015015015015015015015015015015015015015015015015015015015015015015015015015015015015015015015015015015015015015015015015015015015015015015015015015015015015015015015015015015015015015015015015007007007007007007007007007007007007007007007007007007007007007007015015
015015008008008008007007007007007007007007007007007007007007007007007007007007007007007007007007007007007007007007006006006006007007007007007007007007007007007007007007007007007007007007007007007007007007007007007007007007007007007007007007007007007007007007007007007007007007007007007007007007007007007007007007007007007007007007007007007007007007007007007007007007007007007007007007007007007007007007008008008008015015
015015008008008008008008008008008008008008008008007007007007007007007007007007007007007007007007007007007007007007006006006006007007007007007007007007007007007007007007007007007007007007007007007007007007007007007007007007007007007007007007007007007007007007007007007007007007007007007007007007007007007007007007007007007007007007007007007007007007008008008008008008008008008008008008008008008008008008008008008008015015
015015015015015015008008008008008008008008008008008008008008008008008008008008008008008008008008008008008008008008006006006006008008008008008008008008008008008008008008008008008008008008008008008008008008008008008008008008008008008008008008008008008008008008008008008008008008008008008008008008008008008008008008008008008008008008008008008008008008008008008008008008008008008008008008008008008008008008015015015015015015
015015015015015015015015015015015015015015015015008008008008008008008008008008008008008008008008008008008008008008006006006006008008008008008008008008008008008008008008008008008008008008008008008008008008008008008008008008008008008008008008008008008008008008008008008008008008008008008008008008008008008008008008008008008008008008008008008008008008008008008008008008008008015015015015015015015015015015015015015015015015
015015015015015015015015015015015015015015015015015015015015015015015015015015015015015015015015015015015015015015015015015015015015015015015015015015015015015015015015015015015015015015015015015015015015015015015015015015015015015015015015015015015015015015015015015015015015015015015015015015015015015015015015015015015015015015015015015015015015015015015015015015015015015015015015015015015015015015015015015015015015
015015015015015015015015015015015015015015015015015015015015015015015015015015015015015015015015015015015015015015015015015015015015015015015015015015015015015015015015015015015015015015015015015015015015015015015015015015015015015015015015015015015015015015015015015015015015015015015015015015015015015015015015015015015015015015015015015015015015015015015015015015015015015015015015015015015015015015015015015015015015
015015015015015015015015015015015015015015015015015015015015015015015015015015015015015015015015015015015015015015015015015015015015015015015015015015015015015015015015015015015015015015015015015015015015015015015015015015015015015015015015015015015015015015015015015015015015015015015015015015015015015015015015015015015015015015015015015015015015015015015015015015015015015015015015015015015015015015015015015015015015
015015015015015015015015015015015015015015015015015015015015015015015015015015015015015015015015015015015015015015015015015015015015015015015015015015015015015015015015015015015015015015015015015015015015015015015015015015015015015015015015015015015015015015015015015015015015015015015015015015015015015015015015015015015015015015015015015015015015015015015015015015015015015015015015015015015015015015015015015015015015
015015015015015015015015015015015015015015015015015015015015015015015015015015015015015015015015015015015015015015015015015015015015015015015015015015015015015015015015015015015015015015015015015015015015015015015015015015015015015015015015015015015015015015015015015015015015015015015015015015015015015015015015015015015015015015015015015015015015015015015015015015015015015015015015015015015015015015015015015015015015
015015015015015015015015015015015015015015015015015015015015015015015015015015015015015015015015015015015015015015015015015015015015015015015015015015015015014014015015015015015015015015015015015015015015015015015015015015014014015015015015015015015015010010015015015015015015015015015015015015015015015015015015015015015015015015015015015015015015015015015015015015015015015015015015015015015015015015015015015015015015
015015015015015015015015015015015015015015015015015015015015015015015015015015015015015015015015015015015015015015015015015015015015015015015015015015015015014014014014014014014014014014014014014014014014014014014014014014014014015015015015015015010010010010010010015015015015015015015015015015015015015015015015015015015015015015015015015015015015015015015015015015015015015015015015015015015015015015015015015015015015
015015015015015015015015015015015015015015015015015015015015015015015015015015015015015015015015015015015015015015015015015015015015015015015015015015015015014014014014014014014014014014014014014014014014014014014014014014014014015015015015015015015015010010015015015015015015015015015015015015015015015015015015015015015015015015015015015015015015015015015015015015015015015015015015015015015015015015015015015015015015
009009015015015015015015015015015015015015015015015015015015015015015015015015015015015015015015015015015015015015015015015015015015015015015015015015015015014014014014014014014014014014014014014014014014014014014014014014014014015015015015015015015015015015015015015015015015015015015015015015015015015015015015015015015015015015015015015015015015015015015015015015015015015015015015015015015015015015015015015015015015
015015015015015015015015015015015015015015015015015015015015015015015015015015015015015015015015015015015015015015015015015015015015015015015015015015015015014014014014014014014014014014009009009009014014014014014014014014014014015015015015015015015015015015015015015015015015015015015015015015015015015015015015015015015015015015015015015015015015015015015015015015015015015015015015015015015015015015015015015015015015
015015015015015015015015015015015015015015015015015015015015015015015015015015015015015015015015015015015015015015015015015015015015015015015015015015015015015015015015015015015015015015015015015015015015015015015015015015015015015015015015015015015015015015015015015015015015015015015015015015015015015015015015015015015015015015015015015015015015015015015015015015015015015015015015015015015015015015015015015015015015
015015015015015015015015015015015015015015015015015015015015015015015015015015015015015015015015015015015015015015015015015015015015015015015015015015015015015015015015015015015015015015015015015015015015015015015015015015015015015015015015015015015015015015015015015015015015015015015015015015015015015015015015015015015015015015015015015015015015015015015015015015015015015015015015015015015015015015015015015015015015
015015015015015015015015015015015015015015015015015015015015015015015015015015015015015015015015015015015015015015015015015015015015015015015015015015015015015015015015015015015015015015015015015015015015015015015015015015015015015015015015015015015015015015015015015015015015015015015015015015015015015015015015015015015015015015015015015015015015015015015015015015015015015015015015015015015015015015015015015015015015
015015015015015015015015015015015015015015015015015015015015015015015015015015015015015015015015015015015015015015015015015015015015015015015015015015015015015015015015015015015015015015015015015015015015015015015015015015015015015015015015015015015015015015015015015015015015015015015015015015015015015015015015015015015015015015015015015015015015015015015015015015015015015015015015015015015015015015015015015015015015
015015015015015015015015015015015015015015015015015015015015015015015015015015015015015015015015015015015015015015015015015015015015015015015015015015015015015015015015015015015015015015015015015015015015015015015015015015015015015015015015015015015015015015015015015015015015015015015015015015015015015015015015015015015015015015015015015015015015015015015015015015015015015015015015015015015015015015015015015015015015
015015015015015015015015015015015015015015015015015015015015015015015015015015015015015015015015015015015015015015015015015015015015015015015015015015015015015015015015015015015015015015015015015015015015015015015015015015015015015015015015015015015015015015015015015015015015015015015015015015015015015015015015015015015015015015015015015015015015015015015015015015015015015015015015015015015015015015015015015015015015
015015015015015015015015015015015015015015015015015015015015015015015015015015015015015015015015015015015015015015015015015015015015015015015015015015015015015015015015015015015015015015015015015015015015015015015015015015015015015015015015015015015015015015015015015015015015015015015015015015015015015015015015015015015015015015015015015015015015015015015015015015015015015015015015015015015015015015015015015015015015
015015015015015015015015015015015015015015015015015015015015015015015015015015015015015015015015015015015015015015015015015015015015015015015015015015015015015015015015015015015015015015015015015015015015015015015015015015015015015015015015015015015015015015015015015015015015015015015015015015015015015015015015015015015015015015015015015015015015015015015015015015015015015015015015015015015015015015015015015015015015
015015015015015015015015015015015015015015015015015015015015015015015015015015015015015015015015015015015015015015015015015015015015015015015015015015015015015015015015015015015015015015015015015015015015015015015015015015015015015015015015015015015015015015015015015015015015015015015015015015015015015015015015015015015015015015015015015015015015015015015015015015015015015015015015015015015015015015015015015015015015
#
#
#